######################################################################
######################################################################
######                                                           #####
######  ##################  ##########################################
######  ##################  ##########################################
######  ##################  ##########################################
######  ##################  ##########################################
######  #####                                                     ####
######  #####  #######################################################
######  #####  #######################################################
######  #####  #######################################################
######  #####  ############                                         ##
######  #####################################  ###################  ##
######  #####################################  ###################  ##
######                                         ###################  ##
##################################################################  ##
##################################################################  ##
####                                                                ##
####  ################################################################
####                           #######################################
####  #######################  #######################################
####  #######################                                    #####
####  #######################  #######################################
####  ######                   #######################################
######################################################################