##################################################
####              ################################
#### ############ #####               ############
#### ############ ################### ############
#### ############ ################### ############
#### ############ ################### ############
####        ##### ################### ############
#### ###### #####                            #####
#### ###### ##### ################################
########### ##### ################################
########### ##### ################################
####        #####              ###################
################# ############ ############# #####
################# ############ ############# #####
#####             ############ ############# #####
################# ############ ############# #####
################# ########################## #####
################# ########################## #####
########                                     #####
############################################ #####
############################################ #####
############################################ #####
##                                           #####
################################ #################
################################ #################