##################################################
####              ################################
#### ############ #####e              ############
#### ############ ################### ############
#### ############ ################### ############
#### ############ ################### ############
####        ##### ################### ############
#### ###### #####                   |        #####
#### ###### ##### ################################
########### ##### ################################
########### #####-################################
####k       #####              ###################
################# ############ ############# #####
################# ############ ############# #####
#####             ############ ############# #####
################# ############k############# #####
################# ########################## #####
################# ########################## #####
########                                     #####
############################################ #####
############################################ #####
############################################-#####
##k                                          #####
################################ #################
################################ #################