##################################################
##################################################
######                                            
###### #################### ######################
###### #################### ######################
###### #################### ######################
###### #################### ######################
###### ######                                     
###### ###### ####################################
###### ###### ####################################
##################################################
##################################################
######                                            
###### #################### ######################
###### #################### ######################
###### #################### ######################
###### #################### ######################
###### ######                                     
###### ###### ####################################
###### ###### ####################################
##################################################
##################################################
######                                            
###### #################### ######################
###### #################### ######################
###### #################### ######################
###### #################### ######################
###### ######                                     
###### ###### ####################################
###### ###### ####################################
##################################################
##################################################
######                                            
###### #################### ######################
###### #################### ######################
###### #################### ######################
###### #################### ######################
###### ######                                     